V V V V V V V V V V
V M M M M M M M M V
V M V V V V V V M V
V M V V V V V V M V
V M V V V V V V M V
V M V V V V V V M V
V M M M M M M M M V
V V V V V V V V V V